12
150
////////////////////////////////////////
/======_==+=*_=====*=*=======_====*====/
/=*$*======_=========*+==*====_=====_==/
/==========_==_=====*=*==*========*====/
/*=**=========*======*==*====*===*=====/
/*=_*=========**==*========*======*=*_=/
/===_==*========*=====*=_*========*=**=/
/||||||||||||||||||||||||||||||===*==*=/
/=_===*==+=_==*=*==========+=*_======*=/
/==+=====*=====_========*__*==+====*===/
/===*==*=*==============**=*==*========/
/=_=====*========**_=======*==*=+====_=/
/=*==_==*=__=====*=*+==+====*===*==+=*=/
/=+*==============***==*========+=====*/
/========||||||||||||||||||||||||||||||/
/__=========_===+====*=====*===*=======/
/*_=========**==*========*======*=*_==?/
/=*==*========*=====*==__===+===*=**===/
/====*+==_========*======*=*+======*===/
/===_==_=*==*=**=========*=*+======*==*/
/=+====*=====_=========_=*==*====*===*=/
////////////////////////////////////////