24
150
////////////////////////////////////////
/*=||=|**=|===*|*==*====|===*=====*|=+=/
/==$|=+=*=|===|||==|=*====*==*=*===|=|*/
/====|==*+==*====|=====*=||*=======|=||/
/+=|==|*|*==*====|===*======*=**======|/
/*=|===|==*=||==*=||+=======*=**======|/
/**==*====|===*======*=**======*==+||==/
/==*=||==*=**===|====*=**======|==*=|=*/
/==|===+======+=*==||*==*=|=|*==|*==+=|/
/*=*====|=||==+=*==||*==*==+=|===|==*=|/
/=*=||=====**|*==+=|=|*==|*===|*==+=*==/
/|=||======**|*==*=|=||===|==*=||==*=||/
/=|=*=*=|===||*==*====|===*=====||=*=||/
/=|=*=*=|=+=|=|*==|*====*==*=**====|===/
/|==|*|*==*====|===+===|=*|======|=||=+/
/|===||*==|=+===|*==*=*===*=|*======|==/
/|=+====*=||==*=||*=======*=|*======|==/
/==*====|===*======*=**======|==*=|===|/
/*=||==*=||===|====*=**======|==*+==*==?
/|===*======*=*+======*===||==|*==+=|==/
/**===|=====*=*+======|==*=|+=+=*|=*===/
////////////////////////////////////////
